1111111111111
10E0000000001
11111C0000001
10C0000C00P01
1111111111111