1111111111111
10P0000E00001
10C00C0000001
10C0000000001
1111111111111